0000000000000000000000000000000
0111111111111000001111111111110
0100010000001000001000000100010
0100010011111111111111100100010
0300010010000000000000100100030
0100010010000000000000100100010
0100010011111111111111100100010
0100010010000000000000100100010
0111111110000000000000111111110
0100010011111111111111100100010
0100010010001000001000100100010
0100010010001000001000100100010
0111010011112222222111100101110
0001010010002002002000100101000
0001010010002022202000100101000
0001010010002222222000100101000
0001010010002022202000100101000
0001010010002002002000100101000
0111111111112222222111111111110
0100010010001000001000100100010
0100010010001000001000100100010
0100010010001000001000100100010
0100010011111111111111100100010
0100010000001000001000000100010
0100010000001000001000000100010
0300011111111111111111111100030
0100000000001000001000000000010
0100000000001111111000000000010
0100000000001000001000000000010
0111111111111000001111111111110
0000000000000000000000000000000
